swwwwwwwwwwwwcwwwws
s..........tm.mt..s
s.......s.........s
s...t.....f.......s
s.................s
s........t...m....s
s...f.............s
s.............ttt.s
s.....m...........s
s........s....f...s
s..t...........TTTs
s........tp.......s
sssssssssssssssssss
