swwwwwwwwwwwwcwwwws
s..........tm.mt..s
s.......s.........s
s...t.....f.......s
s....f.........f..s
s........t...m....s
s...f.............s
s....f.........ttts
s.....m...........s
s...f.....s....f..s
s..t...........TTTs
s........tp.......s
sssssssssssssssssss